P0,00,00,00,00,06,00,00,00,00,00,00,00,00
00,02,02,00,00,00,00,00,02,02,00,00,00,02
00,00,00,00,00,00,00,00,00,00,00,00,02,00
00,02,00,00,00,00,00,00,00,02,00,00,00,00
00,00,00,02,02,01,00,00,00,00,00,00,00,00
00,00,00,00,02,02,00,00,02,02,00,00,00,00
00,00,00,00,00,05,00,00,00,00,00,00,00,00
00,02,02,03,00,00,00,00,02,02,00,00,00,00
00,00,00,00,00,00,00,00,00,00,00,00,00,00
00,02,00,00,00,00,00,00,00,02,00,00,02,02
00,02,02,00,00,00,00,00,02,00,00,02,00,00
00,00,00,00,00,00,03,00,00,00,00,00,00,00
00,02,00,00,00,00,00,00,00,02,00,00,00,P0